20
8 8 8 8 8 8 8 8 8 7 9 9 9 9 9 9 9 9 9 9
9 0 0 0 0 0 8 0 0 7 0 0 0 0 0 0 0 0 0 9
5 0 0 0 0 0 0 0 0 7 0 0 0 0 0 0 0 0 0 9
9 0 0 0 0 0 8 0 0 7 4 6 10 4 0 4 4 0 0 9
8 8 8 8 8 8 8 0 0 7 0 0 0 0 0 0 4 0 0 9
8 0 0 0 0 0 0 0 0 7 0 0 0 0 0 0 4 0 0 9
8 0 0 0 0 0 0 0 0 7 19 0 0 0 0 0 4 0 0 9
8 0 9 9 9 9 9 12 9 7 7 7 7 11 7 7 4 0 0 9
8 0 6 9 5 5 5 5 9 7 7 7 7 7 7 7 7 0 0 9
8 0 9 9 0 0 0 0 5 7 7 7 7 7 7 0 0 0 0 9
8 0 0 0 0 0 0 0 13 7 0 0 0 0 0 0 0 0 0 12
8 0 9 9 0 0 0 0 5 7 0 0 0 0 0 0 0 0 0 9
8 0 6 9 5 5 5 5 9 7 0 0 0 3 3 3 3 3 3 3
8 0 9 9 9 9 9 9 9 7 0 0 0 0 0 3 3 0 0 3
8 0 0 0 0 0 0 0 0 7 0 0 0 0 0 0 0 0 0 3
8 0 0 0 0 0 0 0 0 7 0 0 0 3 3 3 3 0 0 3
8 0 4 5 6 5 4 0 0 7 0 0 0 3 0 0 3 0 0 3
8 0 4 5 14 5 4 0 0 0 0 0 0 3 0 0 3 0 0 3
8 0 0 0 0 0 0 0 20 8 0 0 8 3 0 0 3 0 0 3
8 8 8 8 8 8 8 8 8 8 8 8 8 3 3 3 3 11 11 3