20
0 0 0 0 0 0 0 0 0 0 0 0 0 0 0 0 0 0 0 0
0 0 0 0 0 0 0 6 6 0 0 0 0 0 0 0 0 0 0 0
0 0 0 0 0 0 6 5 5 0 0 0 0 0 5 5 0 0 0 0
0 0 0 0 0 0 0 4 4 0 0 0 0 0 4 0 0 0 0 0
0 0 0 0 0 0 0 3 3 0 0 0 3 3 3 0 0 0 0 0
0 0 0 0 4 3 2 2 2 0 0 3 2 2 2 3 0 0 0 0
0 0 0 3 3 2 1 1 1 0 3 2 1 1 1 2 3 0 0 0
0 0 0 0 0 0 0 0 0 0 0 0 0 0 0 0 0 4 3 0
0 0 0 0 0 0 0 0 0 0 0 0 0 0 0 0 0 3 2 0
0 0 0 0 4 3 2 1 0 0 0 0 0 0 0 4 3 2 1 0
0 0 6 5 4 3 2 1 0 0 0 0 7 6 5 4 3 2 1 0
0 0 0 0 4 3 2 1 0 0 0 0 7 6 5 4 3 2 1 0
0 0 0 0 0 0 0 0 0 0 0 0 0 0 0 0 0 0 0 0
0 0 0 0 0 0 0 0 0 0 0 0 0 0 0 0 0 6 6 0
0 0 0 0 0 0 0 0 0 0 0 0 0 0 0 0 5 5 5 0
0 0 0 0 0 0 0 0 0 0 0 0 0 0 0 0 0 4 4 0
0 0 0 0 0 0 0 0 0 0 0 0 0 0 0 0 0 3 3 0
0 0 0 0 0 0 0 0 0 0 0 0 0 0 0 0 0 2 2 0
0 0 3 2 1 2 3 0 0 0 0 0 0 0 0 0 0 1 1 0
0 0 0 0 0 0 0 0 0 0 0 0 0 0 0 0 0 0 0 0